
 암기장.



 # Windows 기본 명령어.

copy : 파일 복사.
del : 파일 삭제.
dir : 파일 목록 확인.
ren : 파일 이름 변경.
attrib : 파일 속성 변경.
move : 파일, 디렉토리 변경 및 이동.
type : 텍스트 파일의 내용을 화면에 표시.
find : 특정 문자열 검색.

md : 디렉토리 생성.
cd : 디렉토리 변경.
rd : 디렉토리 삭제.

cls : 화면의 내용을 지움.
date : 현재 날짜와 시간을 표시.

format : 디스크 포맷 ( 초기화 )
chkdisk : 디스크 상태 점검하여 손상부분 복구.


 # Unix 주요 명령어.

chmod : 파일 사용허가 및 파일, 디렉토리의 속성 변경지정.
ls : 지정한 디렉토리의 파일 목록을 보여줌.
cp : 파일 복사 명령.
mv : 파일 및 디렉토리 이동 및 이름변경.
rm : 파일 삭제 명령.
cat : 파일의 내용을 화면에 표시.

cd : 디렉토리 경로 변경.
mkdir : 디렉토리 생성.
rmdir : 디렉토리 삭제.
pwd : 현재 디렉토리의 경로 표시.

passwd : 로그인할 때 사용자 각각의 비밀번호 설정 및 변경.
who : 현재 시스템에 접속한 사용자 표시.
ping : 네트워크상의 다른 컴퓨터들의 연결상태 점검.

shutdown : 작업중인 상태를 체계적으로 종료.
kill : 프로세스 강제 종료.
close : 파일 닫기.
ps : 프로세스 상태 보기.
finger : 시스템에 접속된 사용자 정보 조회.
chown : 파일의 소유권변경.
sleep : 프로세스 수행을 일시 중지.

read : 파일내용을 순차적으로 읽기.
write : 파일에 내용을 순차적으로 기록.



 # OSI 7계층.

물리계층 : 물리적 매체를 통한 전송.
데이터링크 계층 : 오류없이 데이터 전달할 수 있도록 함. ( 프레임 )
네트워크 계층 : 패킷을 목적지까지 전달하는 역할. IP, X.25 ( 패킷 )
전송 계층 : 신뢰성 있고 정확한 데이터 전송 역할 수행. TCP, UDP. ( 세그먼트 )
세션 계층 : 동기 제어, 데이터 회복.
표현 계층 : 암호화, 압축, 코드변환, 구문검색.
응용 계층 : 서비스를 제공.



 # 네트워크.

IPv4
32비트.   
' . ' 로 구분.

IPv6
128비트. 
' : ' 로 구분.



 # Windows Pro 기술.

BitLocker 장치 암호화 : 시스템 드라이브나 usb 이동 저장 장치에 암호를 설정하는 기능.
Windows Information Protection : 컴퓨터 작업 환경에 변화 없이 데이터의 유출을 막는 기술.



 # 인수검사 종류.

형상검사 : 모든 사항들이 제대로 표현되었는지 검사.
알파검사 : 제한된 환경에서 사용자가 개발자의 환경에서 프로그램을 실행하는 테스트.
베타검사 : 제한되지 않은 환경에서 사용자가 프로그램을 실행하는 테스트. ( 게임 베타 테스트 )


 
 # SQL.

DDL : Create, Alter, Drop.
DML : insert, select, update, delete.
DCL : grant, revoke, commit, rollback.

 

 # CRUD

insert into 테이블이름 values( 콜롬1, 콜롬2, ... ) ;

select 콜롬 from 테이블이름 where 조건 group by 조건 having 조건 order by 조건 ;

update 테이블이름 set 콜롬1=데이터1, 콜롬2=데이터2, ... ; 

delete from 테이블이름 where 조건 ;
























